XXXXXXXXXXXXXXXXXXXXXXXXXXXXXXX
XSX     X X       X X X   X X X
X X XXX X XXX X XXX X X XXX X X
X     X X   X X X   X         X
XXX XXXXXXX XXX X XXX XXXXXXXXX
X   X   X     X X X   X X   X X
XXX X X XXX XXX X X XXX X X X X
X   X X   X X X X X X X   X   X
XXX XXX XXX X X X X X X X X X X
X   X X   X       X     X X X X
X X X XXX XXXXX XXXXX XXXXXXXXX
X X   X   X X     X           X
XXX XXXXX X XXX XXX X XXX XXXXX
X X X X             X X X   X X
X X X XXXXX X XXXXX XXX XXXXX X
X   X X X X X   X X X     X X X
X X X X X XXX XXX X X XXX X X X
X X               X X   X X   X
XXX XXX XXX XXX X XXX XXXXXXX X
X     X X   X X X             X
XXXXXXXXX XXX XXX XXXXXXX XXXXX
X X         X         X       X
X X XXXXXXX X X X X XXX XXXXXXX
X       X   X X X X   X X     X
X X X XXX X XXXXX X XXXXXXX XXX
X X X X   X X X   X     X X   X
X X XXXXXXXXX XXX XXXXXXX X XXX
X X X X X                     X
XXX X X X X X XXX XXX XXXXXXX X
X   X     X X X   X         XFX
XXXXXXXXXXXXXXXXXXXXXXXXXXXXXXX
