XXXXXXXXXXXXXXX
XS            X
X XXX XXXXX X X
X X     X   X X
XXXXX XXX X XXX
X       X X   X
XXXXXXXXXXX XXX
X   X   X     X
XXX XXX X X XXX
X X X     X   X
X X XXXXX XXX X
X         X   X
X XXX X X XXX X
X X   X X X  FX
XXXXXXXXXXXXXXX
